algeria	aradiciax
austohungarian	hrajnvier
canada	janter uldosey	
columbia	ctholkands	
denmark	neaslands	
france	urdines	
germany	uthwaster	
greek	theba	
italy	caras	
labrador	kedana	
morroco	koloc	
norway	varlund	
ottoman	marczech	
persia	styriands	
portugal	doistra	
russia	raxem	
spain	nira	
sweden	rybeser	
tunisia	dirinion	
uk	marsland	
us	united nythr territories
brazil	zagui
mexico	siavera	

Arsalan Khareghat



















	
